################################################################################################################
#                                                                                                              #
#                                                                                                              #
#                                                                                                              #
#                                             M                                                                #
#                                                                                                              #
#                                                                                                              #
#                  #                                                                                           #
#    P          C  #                                                                                           #
#           #      #         S    **                                                                           #
#           #      #                                                                                           #
##################@#############################################################################################