################################################################################################################
#                                                                                                              #
#                                                                                                              #
#                                                                                                              #
#                                                                                                              #
#                                                                                                              #
#                                                                                                              #
#                                                                                                              #
#   J P                                                                                                        #
#                                                                                                              #
#                                                                                                              #
################################################################################################################