################################################################################################################
#                                                                                                              #
#                                                                                                              #
#                                                                                                              #
#                                                                                                              #
#                                                                                                              #
#                                                                                                              #
#                                                                                                              #
#      P     S                      S      M                                                                   #
#                                                                                                              #
#               *                                                                                              #
################################################################################################################