################################################################################################################
#                                                                                                              #
#                                                                                                              #
#                                                                                                              #
#                                                                                                              #
#                                                                                                              #
#                                                                                                              #
#                                                                                                              #
#      J P                   SSSSS             *****                       M                                   #
#                                                                                                              #
#                                                                                                              #
################################################################################################################