################################################################################################################
#                                                                                                              #
#                                                                                                              #
#                                                                                                              #
#                                                                                                              #
#                                                                                                              #
#                                                                                                              #
#                                                                                                              #
#      J P                                                                                                     #
#             *****                                                                                            #
#                                                                                                              #
################################################################################################################